10 11

0 2 0 0 2 2 2 2 0 2 2
2 0 0 0 0 2 0 2 0 2 0
0 2 0 2 0 2 2 2 0 0 0
0 2 0 2 0 2 0 2 0 0 0
2 2 2 2 2 0 0 0 0 2 0
0 0 0 2 2 2 2 2 0 0 2
2 0 0 0 2 2 2 2 2 0 0
2 2 2 2 0 0 0 0 0 0 2
0 0 0 2 2 0 2 0 2 0 2
0 2 0 2 2 2 0 2 0 2 2

horizental wall:
0 1 0 0 0 0 0 1 1 1 0
1 0 0 1 0 0 1 0 0 0 0
0 0 1 0 1 1 0 0 0 1 1
1 1 0 0 0 1 0 1 1 0 0
0 0 0 0 1 1 1 1 1 1 0
0 1 0 0 0 0 0 1 1 0 1
0 0 0 0 0 0 1 1 0 0 1
1 0 0 1 1 1 0 0 0 1 0
0 1 1 0 0 1 1 0 0 1 0

vertical wall:
0 0 0 0 1 0 0 1 0 0
1 0 1 0 1 1 0 0 0 1
1 0 0 1 0 0 1 1 1 0
0 1 0 0 0 0 1 0 1 1
1 1 0 0 0 0 0 0 1 0
0 0 1 0 0 0 0 0 1 0
1 0 0 1 1 1 1 0 0 0
1 0 0 0 1 1 1 1 1 0
0 0 0 0 0 0 0 0 0 0
0 0 1 0 0 0 0 1 0 0

1 4	